PokerStars Hand #100630318083:  Hold'em No Limit ($0.01/$0.02 USD) - 2013/06/27 5:21:19 ET
Table 'Huenna' 9-max Seat #2 is the button
Seat 2: LuckyIvan87 ($2.16 in chips) 
Seat 3: Mcpchk ($5 in chips) 
Seat 4: kalita-1 ($0.74 in chips) 
Seat 6: smpymg ($1.21 in chips) 
Seat 8: LinPu ($1.60 in chips) 
Seat 9: masspri ($5.28 in chips) 
Mcpchk: posts small blind $0.01
kalita-1: posts big blind $0.02
LinPu: posts big blind $0.02
*** HOLE CARDS ***
Dealt to LinPu [Jd Kd]
smpymg: folds 
LinPu: raises $0.06 to $0.08
masspri: calls $0.08
LuckyIvan87: folds 
Mcpchk: folds 
kalita-1: folds 
*** FLOP *** [4s Qd 8c]
LinPu: bets $0.08
masspri: raises $0.08 to $0.16
LinPu: calls $0.08
*** TURN *** [4s Qd 8c] [Kh]
LinPu: bets $0.08
masspri: folds 
Uncalled bet ($0.08) returned to LinPu
MatroSkin280 joins the table at seat #1 
LinPu collected $0.49 from pot
*** SUMMARY ***
Total pot $0.51 | Rake $0.02 
Board [4s Qd 8c Kh]
Seat 2: LuckyIvan87 (button) folded before Flop (didn't bet)
Seat 3: Mcpchk (small blind) folded before Flop
Seat 4: kalita-1 (big blind) folded before Flop
Seat 6: smpymg folded before Flop (didn't bet)
Seat 8: LinPu collected ($0.49)
Seat 9: masspri folded on the Turn



PokerStars Hand #100630332259:  Hold'em No Limit ($0.01/$0.02 USD) - 2013/06/27 5:21:57 ET
Table 'Huenna' 9-max Seat #3 is the button
Seat 2: LuckyIvan87 ($2.16 in chips) 
Seat 3: Mcpchk ($5 in chips) 
Seat 4: kalita-1 ($0.72 in chips) 
Seat 5: draniceru88 ($1.62 in chips) 
Seat 6: smpymg ($1.21 in chips) 
Seat 8: LinPu ($1.85 in chips) 
Seat 9: masspri ($5.04 in chips) 
kalita-1: posts small blind $0.01
draniceru88: posts big blind $0.02
MatroSkin280: sits out 
*** HOLE CARDS ***
Dealt to LinPu [7d 5s]
smpymg: folds 
LinPu: folds 
masspri: raises $0.02 to $0.04
LuckyIvan87: folds 
Mcpchk: folds 
kalita-1: folds 
draniceru88: folds 
Uncalled bet ($0.02) returned to masspri
masspri collected $0.05 from pot
*** SUMMARY ***
Total pot $0.05 | Rake $0 
Seat 2: LuckyIvan87 folded before Flop (didn't bet)
Seat 3: Mcpchk (button) folded before Flop (didn't bet)
Seat 4: kalita-1 (small blind) folded before Flop
Seat 5: draniceru88 (big blind) folded before Flop
Seat 6: smpymg folded before Flop (didn't bet)
Seat 8: LinPu folded before Flop (didn't bet)
Seat 9: masspri collected ($0.05)



PokerStars Hand #100630341306:  Hold'em No Limit ($0.01/$0.02 USD) - 2013/06/27 5:22:21 ET
Table 'Huenna' 9-max Seat #4 is the button
Seat 2: LuckyIvan87 ($2.16 in chips) 
Seat 3: Mcpchk ($5 in chips) 
Seat 4: kalita-1 ($0.71 in chips) 
Seat 5: draniceru88 ($1.60 in chips) 
Seat 6: smpymg ($1.21 in chips) 
Seat 8: LinPu ($1.85 in chips) 
Seat 9: masspri ($5.07 in chips) 
draniceru88: posts small blind $0.01
smpymg: posts big blind $0.02
MatroSkin280: sits out 
*** HOLE CARDS ***
Dealt to LinPu [5d 9d]
LinPu: folds 
masspri: folds 
LuckyIvan87: folds 
Mcpchk: folds 
kalita-1: folds 
draniceru88: raises $0.02 to $0.04
smpymg: folds 
Uncalled bet ($0.02) returned to draniceru88
draniceru88 collected $0.04 from pot
*** SUMMARY ***
Total pot $0.04 | Rake $0 
Seat 2: LuckyIvan87 folded before Flop (didn't bet)
Seat 3: Mcpchk folded before Flop (didn't bet)
Seat 4: kalita-1 (button) folded before Flop (didn't bet)
Seat 5: draniceru88 (small blind) collected ($0.04)
Seat 6: smpymg (big blind) folded before Flop
Seat 8: LinPu folded before Flop (didn't bet)
Seat 9: masspri folded before Flop (didn't bet)



PokerStars Hand #100630347406:  Hold'em No Limit ($0.01/$0.02 USD) - 2013/06/27 5:22:37 ET
Table 'Huenna' 9-max Seat #5 is the button
Seat 2: LuckyIvan87 ($2.16 in chips) 
Seat 3: Mcpchk ($5 in chips) 
Seat 4: kalita-1 ($0.71 in chips) 
Seat 5: draniceru88 ($1.62 in chips) 
Seat 6: smpymg ($1.19 in chips) 
Seat 8: LinPu ($1.85 in chips) 
Seat 9: masspri ($5.07 in chips) 
smpymg: posts small blind $0.01
LinPu: posts big blind $0.02
MatroSkin280: sits out 
*** HOLE CARDS ***
Dealt to LinPu [Th 5h]
masspri: folds 
LuckyIvan87: folds 
Mcpchk: folds 
kalita-1: folds 
draniceru88: folds 
smpymg: folds 
Uncalled bet ($0.01) returned to LinPu
LinPu collected $0.02 from pot
*** SUMMARY ***
Total pot $0.02 | Rake $0 
Seat 2: LuckyIvan87 folded before Flop (didn't bet)
Seat 3: Mcpchk folded before Flop (didn't bet)
Seat 4: kalita-1 folded before Flop (didn't bet)
Seat 5: draniceru88 (button) folded before Flop (didn't bet)
Seat 6: smpymg (small blind) folded before Flop
Seat 8: LinPu (big blind) collected ($0.02)
Seat 9: masspri folded before Flop (didn't bet)



PokerStars Hand #100630355419:  Hold'em No Limit ($0.01/$0.02 USD) - 2013/06/27 5:22:58 ET
Table 'Huenna' 9-max Seat #6 is the button
Seat 2: LuckyIvan87 ($2.16 in chips) 
Seat 3: Mcpchk ($5 in chips) 
Seat 4: kalita-1 ($0.71 in chips) 
Seat 5: draniceru88 ($1.62 in chips) 
Seat 6: smpymg ($1.18 in chips) 
Seat 8: LinPu ($1.86 in chips) 
Seat 9: masspri ($5.07 in chips) 
soundgear31 will be allowed to play after the button
LinPu: posts small blind $0.01
masspri: posts big blind $0.02
MatroSkin280: sits out 
*** HOLE CARDS ***
Dealt to LinPu [Ah 8h]
LuckyIvan87: folds 
Mcpchk: raises $0.02 to $0.04
kalita-1: folds 
draniceru88: folds 
smpymg: folds 
LinPu: raises $0.04 to $0.08
masspri: folds 
Mcpchk: calls $0.04
*** FLOP *** [Qd Ad 4h]
LinPu: bets $0.08
Mcpchk: calls $0.08
*** TURN *** [Qd Ad 4h] [Ts]
LinPu: bets $0.08
Mcpchk: folds 
Uncalled bet ($0.08) returned to LinPu
LinPu collected $0.33 from pot
*** SUMMARY ***
Total pot $0.34 | Rake $0.01 
Board [Qd Ad 4h Ts]
Seat 2: LuckyIvan87 folded before Flop (didn't bet)
Seat 3: Mcpchk folded on the Turn
Seat 4: kalita-1 folded before Flop (didn't bet)
Seat 5: draniceru88 folded before Flop (didn't bet)
Seat 6: smpymg (button) folded before Flop (didn't bet)
Seat 8: LinPu (small blind) collected ($0.33)
Seat 9: masspri (big blind) folded before Flop



PokerStars Hand #100630376729:  Hold'em No Limit ($0.01/$0.02 USD) - 2013/06/27 5:23:55 ET
Table 'Huenna' 9-max Seat #8 is the button
Seat 1: MatroSkin280 ($0.80 in chips) 
Seat 2: LuckyIvan87 ($2.16 in chips) 
Seat 3: Mcpchk ($5 in chips) 
Seat 4: kalita-1 ($0.71 in chips) 
Seat 5: draniceru88 ($1.62 in chips) 
Seat 6: smpymg ($1.18 in chips) 
Seat 8: LinPu ($2.03 in chips) 
Seat 9: masspri ($5.05 in chips) 
masspri: posts small blind $0.01
MatroSkin280: posts big blind $0.02
soundgear31: sits out 
*** HOLE CARDS ***
Dealt to LinPu [Ad 3c]
LuckyIvan87: folds 
Mcpchk: folds 
kalita-1: calls $0.02
draniceru88: folds 
smpymg: folds 
LinPu: folds 
masspri: calls $0.01
MatroSkin280: checks 
*** FLOP *** [7h Ac Ts]
masspri: bets $0.04
MatroSkin280: folds 
kalita-1: folds 
Uncalled bet ($0.04) returned to masspri
masspri collected $0.06 from pot
*** SUMMARY ***
Total pot $0.06 | Rake $0 
Board [7h Ac Ts]
Seat 1: MatroSkin280 (big blind) folded on the Flop
Seat 2: LuckyIvan87 folded before Flop (didn't bet)
Seat 3: Mcpchk folded before Flop (didn't bet)
Seat 4: kalita-1 folded on the Flop
Seat 5: draniceru88 folded before Flop (didn't bet)
Seat 6: smpymg folded before Flop (didn't bet)
Seat 8: LinPu (button) folded before Flop (didn't bet)
Seat 9: masspri (small blind) collected ($0.06)



PokerStars Hand #100630387329:  Hold'em No Limit ($0.01/$0.02 USD) - 2013/06/27 5:24:23 ET
Table 'Huenna' 9-max Seat #9 is the button
Seat 1: MatroSkin280 ($0.78 in chips) 
Seat 2: LuckyIvan87 ($2.16 in chips) 
Seat 3: Mcpchk ($5 in chips) 
Seat 4: kalita-1 ($0.69 in chips) 
Seat 5: draniceru88 ($1.62 in chips) 
Seat 6: smpymg ($1.18 in chips) 
Seat 8: LinPu ($2.03 in chips) 
Seat 9: masspri ($5.09 in chips) 
MatroSkin280: posts small blind $0.01
LuckyIvan87: posts big blind $0.02
soundgear31: sits out 
*** HOLE CARDS ***
Dealt to LinPu [7s Qc]
Mcpchk: folds 
kalita-1: calls $0.02
draniceru88: folds 
smpymg: folds 
LinPu: folds 
masspri: folds 
MatroSkin280: folds 
LuckyIvan87: checks 
*** FLOP *** [9d Ts 6c]
LuckyIvan87: checks 
kalita-1: checks 
*** TURN *** [9d Ts 6c] [Kd]
LuckyIvan87: checks 
kalita-1: checks 
*** RIVER *** [9d Ts 6c Kd] [9s]
LuckyIvan87: checks 
kalita-1: checks 
*** SHOW DOWN ***
LuckyIvan87: shows [7c As] (a pair of Nines)
kalita-1: shows [Ac 2h] (a pair of Nines)
LuckyIvan87 collected $0.03 from pot
kalita-1 collected $0.02 from pot
*** SUMMARY ***
Total pot $0.05 | Rake $0 
Board [9d Ts 6c Kd 9s]
Seat 1: MatroSkin280 (small blind) folded before Flop
Seat 2: LuckyIvan87 (big blind) showed [7c As] and won ($0.03) with a pair of Nines
Seat 3: Mcpchk folded before Flop (didn't bet)
Seat 4: kalita-1 showed [Ac 2h] and won ($0.02) with a pair of Nines
Seat 5: draniceru88 folded before Flop (didn't bet)
Seat 6: smpymg folded before Flop (didn't bet)
Seat 8: LinPu folded before Flop (didn't bet)
Seat 9: masspri (button) folded before Flop (didn't bet)



